R 1920 1080000000000000000000000000000000000000


NO texture/text_3.xpm 
SO texture/text_7.xpm
WE texture/text_9.xpm
EA texture/text_12.xpm
S texture/sakura.xpm
C 135,198,235
F 48,175,22

1111111
100S001
1000001
1000001
1000001
1000001
1000001
1000001
1000001
100000111111111111
100000000000000001
100000000000000001
100000000000000001
100000000000000001
100000000000000001
100000002000000001
100000000000000001
100000000000000001
100000000000000001
100000000000000001
100000000000000001
111111111111111111