R 1500 710
NO texture/no.xpm
SO texture/so.xpm
WE texture/we.xpm
EA texture/ea.xpm
S texture/sprite.xpm
F 0, 204, 68
C 128, 191, 255
   
    111111111111111111111111111111111111111111111111111111 
    110000000000000000000000000000000000000000000000000011       11111111111111111
    110000000000000000000000000000000000000000000000000011       10000000000000001
    110000000000000000000000000000000000000000000000000011111111110000000000000001
    110000000000000000000000000000000000000000000000000000000000000000000000000001
    110000000000000000200000000000000000000000000000000000000000000000000000000001
    110000000000000000000000000000000000000000000000000011111111110000000000000001
    110000000000000000000000000000000000000000000000000011       1000000000000000111111111
    110000000000000000000000000000000000000000000000000011       1000000000000000000000001
    110000000000000000000000000000000000000000000000000011   11111000000000000000000000001
    110000000000000000000000000000000000000000000000000011   10000000000000000000000000001
    110000000000000000000000000000000000000000000000000011   10000000000000000000000000001
    110000000000000000N00000000000000000000000000000000011   11111111111111111111111111111
    11111111111111111111111111111111111111111111111111111