R 1600 900
NO 1.xpm
SO 1.xpm
WE 3.xpm
EA 4.xpm
S 4.xpm
F 220,100,0
C 225,30,0
   
   
    11111111111111111111111111111111111111111111111111111
    11000000000000000000000000000000000000000000000000001
    11000000000000000000000000000000000000000000000000001
    11000000000000000000000000000000000000000000000000001
    11000000000000000000000000000000000000000000000000001
    1100000000000000000000000000000000000000000000000001
    11000000000000000000000000010000000000000000000000001
    11000000000000000000000000100000000000000000000000001
    11000000000000000000000000000000000000000000000000001
    110000000000000000000000N0000000000000000000000000001
    11000000000000000000000000000000000000000000000000001
    11000000000000000000000000000000000000000000000000001
    11000000000000000000000000000000000000000000000000001
    11111111111111111111111111111111111111111111111111111