




R             1366                768
          NO               ./path_to_the_north_texture
SO             ./path_to_the_south_texture


                   





S                     ./path_to_the_sprite_texture
F      225,             225,                 255
C 0           ,55,               255





WE                   ./path_to_the_west_texture
EA              ./path_to_the_east_texture







1111111111111111111111111 1111111111111
12222222222222222222222222222222222221
12000000000000000000000000000000000021
12000000000000000000000000000000000021
12000000000000000000000000000000000021
12000000000000000000000000000000000021
12000000000000000000000000000000000021
12000000000000000000000000000000000021
12000000000000001111100000000000000021
12000000000000000000000000000000000021
12000000000000000000000000000000000021
12000000000002001111110000000000000021
1200000000000100000000010000000000021
12000000000002000E0000010000000000021
1200000000000200000000010000000000021
1200000000000100111222000000000000021
1200000000000000000000000000000000021
1200000000000000000000000000000000021
1200000000000000000000000000000000021
1200000000000000000000000000000000021
1200000000000000000000000000000000021
1200000000000000000000000000000000021
1200000000000000000000000000000000021
1200000000000000000000000000000000021
1222222222222222222222222222222222221
 111111111111111111111111111111111111
