R 1500 710
NO texture/no.xpm
SO texture/so.xpm
WE texture/we.xpm
EA texture/ea.xpm
S texture/sprite.xpm
F 0, 204, 68
C 128, 191, 255

111111111111111111111111111111111111111111111111111111
100000000000000000000000000000000000000000000000000001
100000000000000000000000000000000000000000000000000001
100000000000000000000000000000000000000000000000000001
100000000000000000022222222222220000000000000000000001
100000000000000000022222222222220000000000000000000001
100000000000000000022222222222220000000000000000000001
100000000000000000022222222222220000000000000000000001
100000000000000000022222222222220000000000000000000001
100000000000000000022222222222220000000000000000000001
100000000000000000022222222222220000000000000000000001
100000000000000000022222222222220000000000000000000001
100000000000000000022222222222220000000000000000000001
100000000000000000022222222222220000000000000000000001
100000000000000000022222222222220000000000000000000001
100000000000000000000000000000000000000000000000000001
100000000000000000000000000000000000000000000000000001
100000000000000000000000000000000000000000000000000001
100000000000000000000000000000000000000000000000000001
100000000000000000000000000000000000000000000000000001
100000000000000000000000000000000000000000000000000001
100000000000000000000000000000000000000000000000000001
100000000000000000000000000000000000000000000000000001
100000000000000000000000000000000000000000000000000001
100000000000000000000000000000000000000000000000000001
100000000000000000000000000000000000000000000000000001
100000000000000000000000000000000000000000000000000001
100000000000000000000000000000000000000000000000000001
100000000000000000000000000000000000000000000000000001
100000000000000000000000000000000000000000000000000001
100000000000000000000000000000000000000000000000000001
100000000000000000000000000000000000000000000000000001
100000000000000000000000N00000000000000000000000000001
111111111111111111111111111111111111111111111111111111