




R             1920                1080
          NO               ./path_to_the_north_texture
SO             ./path_to_the_south_texture


                   





S                     ./path_to_the_sprite_texture
F      225,             225,                 255
C 0           ,55,               255





WE                   ./path_to_the_west_texture
EA              ./path_to_the_east_texture







111111111111111111111
10000S000000000000001
1100000000000000000111
  11111000000000000000111111
  10000000111110000000111111111111
  1111111110000000000000000011
      11100000001111100000001
      11100000001111100000001
      11100000001111100000001
      111000000011  100000001
      111000000011  100000001
      111000000001  100000001
      111000000011  100000001
      111000000001  100000001
      111000000011  100000001
      11100000001111100000001
      11100000001111100000001
      11100000001111100000001
1111111111111111110000000111111
10000000000000000001111111
1111111111111111111111111111111