R 1000 1000
NO texture/text_7.xpm
SO texture/text_2.xpm
WE texture/tex\ t_5.xpm
EA texture/text_4.xpm
S texture/spruce.xpm
C 2,165,231
F 48,175,22

11111111111111111111
10000000000000000001
10000000000000000001
10000000010000000001
10000000000000000001
100000010N0100000001
10000000000000000001
10000000010000000001
10000000000000000001
10000000000000000001
11111111111111111111