




R             1500               1500
          NO               ./1.xpm
SO				./2.xpm


                   





S                     ./3.xpm
F      225,             225,                 255
C 0           ,55,               255





WE                   ./3.xpm
EA              ./4.xpm







1111111111111
1000000000001
1000000000001
1000001000001
1000110101001
100000N000001
1000000000001
1111111111111