R      1200000 50000
NO  texture/no.xpm
SO    texture/so.xpm
WE  texture/we.xpm
EA    texture/ea.xpm
S    texture/sprite.xpm
F    0,204,6
C             128,191,255



11111111111111111
10000000200000001
10000011111000001
10000000000000001
10000000000000001
10000000000000001
1E000000200000001
10000000000000001
10000000000000001
10000000000000001
10000000000000001
10000000000000001
11111111111111111