R 1500 710
NO texture/no.xpm
SO texture/so.xpm
WE texture/we.xpm
EA texture/ea.xpm
S texture/boy.xpm
F 0, 204, 68
C 128, 191, 255

1111111111111111111111111111111111
1000000000000000000000000000000001
1000000000000000000000000000000001
1000000000000000000000000000000001
1E00000000000000000000000200000001
1000000000000000000000000000000001
1000000000022222200000000000000001
1000000000000000000000000000000001
1111111111111111111111111111111111