R 1920 1080
NO ./path_to_the_north_texture
SO ./path_to_the_south_texture
WE ./path_to_the_west_texture
EA ./path_to_the_east_texture
S ./path_to_the_sprite_texture
F 225,30,0
C 225,30,9

         1 1111111111      111111111     1111111111                       
           1000000001     1000000001     1000000001                               111111
           1000000001     1000000001     1000000001                        1111111111111111
           1000000001     1000000001     1000000001                   11111111
           1000000001     1000000001     1000000001               11110111
           1000000001111111000000001111111000000001         11111111111          
           1111000000000000000000000000000000001111          1111111         
           1111011110001111000000001111000111101111   1111111111
111111111111111111111111111111111111111111111111111111111
11111111111111111111111111111111111111111111111111111
           1110001110001111111110011111110001000111
           1110001110001111111110011111110101000111
           111000111000111111111001111111101000111011
           1110001110001111111110011111110101000111
           1110001110001111111110011111110001000111                     
           11100011100011111100111111110001110001111
           1110001110001111110011111111000111000111    
         1110001110001111110011111111000111000111               1
         11100011100011211100111111111000111000111
         1110001110001111110011111111000111000111              
         1110001110001111111001111111000111000111
           1110001100000000000000000000000111000111
           1110001100000000000000000000000111000111              
           1110001100000000000000000000000111000111
           1110001100000000000000000000000111000111
           1110001100000000000000000000000111000111            
           1110000001111111110000111111111000000111
           1000000001     1000000001     1000000001            
           1000000001     1000000001     1000000001
           1000000001     1000000001     1000000001    
           1111111111     1111111111     1111111111                    1
1
           1